%%%%%%%%%%%%%%%%%%%
% G               %
%                 %
%                 %
%                 %
%                 %
%                 %
%                 %
%                 %
%          %      %
%         .%      %
%        %%%      %
%                 %
%                 %
%            P    %
%                 %
%                 %
%                 %
%%%%%%%%%%%%%%%%%%%