%%%%%%%%%%%%%%%%%%%
%                 %
%                 %
%                 %
% G               %
%                 %
%                 %
%                 %
%                 %
%          %      %
%         .%      %
%          %      %
%                 %
%       P         %
%                 %
%                 %
%                 %
%                 %
%%%%%%%%%%%%%%%%%%%