%%%%%%%%%%%%%%%%%%%
%                 %
%                 %
%                 %
%G                %
%                 %
%                 %
%                 %
%                 %
%          %      %
%         .%      %
%        %%%      %
%           P     %
%                 %
%                 %
%                 %
%                 %
%                 %
%%%%%%%%%%%%%%%%%%%