%%%%%%%%%%%%%%%%%%%
%                 %
%                 %
% G               %
%                 %
%                 %
%                 %
%                 %
%                 %
%          %      %
%         .%      %
%        %%%      %
%             P   %
%                 %
%                 %
%                 %
%                 %
%                 %
%%%%%%%%%%%%%%%%%%%