%%%%%%%%%%%%%%%%%%%
% G               %
%                 %
%                 %
%                 %
%                 %
%                 %
%                 %
%                 %
%          %      %
%         .%      %
%        %%%      %
%           P     %
%                 %
%                 %
%                 %
%                 %
%                 %
%%%%%%%%%%%%%%%%%%%